          %
        ^^^=^^
%          =       %
##    _____=    /####\       %
##         =   /###^^^^^^   ##
## @       =  /####         ##
#####    ##########_________##
##############################
